11111111111111111
10C010000000C0001
10000010011000001
10000110000000001
1000011000C000001
10000110000000001
100001100000C0001
10P0011E000000001
11111111111111111
